##################################################
# *  ###..       **#           *.             **@#
#.@# *...@##$#   *@# **  #####$@@####$########@**#
#$#   @@#@* #. *#@@#   * #     #$     #+     +@@@#
# #*# ###@# #@+# #@#  *  # **  @#  *  #$      +#@#
# .@  *..@#   @  #     * #   * #@ * * #$       # #
#*$#   @@#$###@+ ### **  # **  @# *** #$       # #
#@ #*# ###  ..@@*#       # *   #@ *   #$       # #
## .@  *..  .@+@#* $###### *** @#  ** #$       # #
##*$#   @@#*  @+#@##     +     #@     #$       # #
#.@ #*# ####$  @@@.. ### .+### @##### #$       # #
#+# .@  *...#$   #@@#   # @*@ . @.@.@.#$       # #
# #*$#   @@*+@ $* @@ *    +@+*+.*@.@# #$       # #
# .@ #*# #@+.   ######+  +@*@+.*@.@.@. $       # #
#*+# .@  *+@.#$.     #@.+@***@+.* .@*@#$       # #
#@ #*$#   @+.@.@ *** # @.+@*@+.*#######$       # #
## .@ #*# #@.@.# *   #..@.+@*@*#  ..  #$      ## #
##*+# .@  *+@@#$  *  #   @ ##### #@@# #$  $    # #
#.@ #*$#   @+  #   * #**#         ..    #$   #*  #
# # .@ #*# #@# # **  ####$########@@###  @  ##@# #
#.#*+# .@  *+$ #                  ..  ###@## *#  #
#*.@ #*$#   @# ##########$########@@# #  @    #*##
#. # .@ #*# ##     ..            .@@    #@###  @ #
#@.#*+# .@  *+#$###@@####$##   * #@ #####@$#$ $  #
# ..@ #*$#   @*#   @@    **# *** # $    #@@+@ @# #
#...# .@ #*# ### ####### K*# * * # @+    $@@+$@# #
#* .#*+# .@  *.. $#     #**#  ** $+@@+  $@@@@+@# #
#@.*.@ #*$#   @@#$  *** #**#   * #@@@@+$@@@@@@+# #
#.. .# .@ #*# ###@.  *  #@@#     #**@#$@@@@@@@@# #
#.@..#*+# .@  *..##  *  ###$#####$####@@@@@@@@@# #
#.@...@ #*$#   @@*# **  *             +@@@@@@@@# #
#*@.@ # .@ #*# #@*#  *  # ##########+  +@@@@@@@# #
#. .@*#*+# .@  *+#$     # #$*$*$*$*$@+  +@@@@@@# #
#..*...@ #*$#   @*# ##### #*######+*$@+  +@@@@@# #
#.@.@..# .@ #*# ### #***  #$#      +*$@+  +@@@@# #
#*... .#*+# .@  *.. #@@*# #         +*$@+  +@@@# #
#. *@.@.@ #*$#   @@#*@@*# #          +*$@+  +@@# #
#.......# .@ #*# #####@@+   # #       +*$@+  +@# #
#@. . ..#*+# .@  *...*#@@#  # # #      +*$@+  +# #
#...*.@..@ #*$#   @@#..#$#  ### #    #  +*$@+  + #
#..@...* # .@ #*# ###@ #*#  # # ##+  #   +*$@+.* #
#@.*. ...#*+# .@  @  $ #$#  +#+ # #  #    +*$#@@+#
#.....@...@ #*$# #@# . #*+      ##+  #     +*+@@@#
#.*..*. *.# .@ #*#@$#@ +$*+         ###    #$*+@@#
#... .....#*+# .@ @@$#  +$*+               $+$*+@#
#.@...@..  @ #*$##@@@$#  +$*+#################$#@#
#*..@.. *..# .@ #*@@@@$#  +$*$*$*$*$*$*$*$*$*$*#@#
# .@..*....#*+# .@@@@@@$#  +#################### #
#...........@ #*$#@@@@@@@#                       #
##################################################
