##################################################
#         #* .#                                  #
# #@#######  .                                   #
# #.......# ..#                                  #
# #.      # *.#                                  #
# #. *  * # ..#                                  #
# #.      # ..#                                  #
# #.    + # ..#                                  #
# +. * ++ @@..#                                  #
# @.      # ###                                  #
#         #....                                  #
# #.#######....                                  #
# #......*#....                                  #
# #.###.###....                                  #
# #.#.....#.@@@                                  #
# #.#.#####....                                  #
# #.#.#.*##....                                  #
# #.#.#.###.                                     #
# #.#.....#. .                                   #
# #.#######. .                                   #
# #  *    #.  .                                  #
#         #.. .                                  #
#     @   ##. .                                  #
# #  @@...#.. .                                  #
# # @@+...... .                                  #
# #.......#.  .                                  #
# #.+++++.#.*.                                   #
# #+*****.#..                                    #
# #.+++++.#                                      #
# *#......#                                      #
#  #    ##K                                      #
#  # # #K# ++++                                  #
# ##  #  #  @@@                                  #
# ### * .#                                       #
# ## *  @#*                                      #
#  #      #.. .                                  #
#  #    ###.. .                                  #
#  # ## .##.. .                                  #
# ##  ##..#.. .                                  #
#  #####.##.. .                                  #
#   +  ####.. .                                  #
# #   **   .. .                                  #
# # ******  . .                                  #
# # @@@@@@+ . .                                  #
# #   @@  + . .                                  #
#          .. .                                  #
#####     ... @                                  #
#***#####....                                    #
#         .....                                  #
##################################################
