##################################################
#...#   .    .    .  $.............*.*.** * $ $  #
#.*.# ##@#  #@# #.@# #..###..#...#.#*.*#@.@.# @.*#
##.## #**.. #   #@K$ #.# .*#.#...#.##*.#.*.*# #*.#
#***# ##### #   #### #.# * ..#...#.#*#*#@.@.# #@*#
#@.@#   #   #  .#  # #.# *.@.#.#.#.#.+.#.*.*# ####
#   ### ##  #  @#  # #.#  @#.##*##.# .+# .@.    .#
#   ..  +####    ##  #  ###..#.@.#.# @.+ #######$#
#   @.#              #     .          @   @ . . .#
#    @#              ## *##@##### #########. . . #
#     #        #### #### *###  *# #  # *  ##. . .#
# #####  +#    #*   #*.## *#   @     #* *.#. ##. #
#         +#####    # *.##    ########## @# #**# #
# ##### #  @...#  ###  *.#### *# .$..# .  # @  @ #
# #*#*# #  ....#  $##.  *.  # *#. #*.+ @  #  ##  #
# **#** #####...  *$#@    #   *# .#@*$    #      #
#########.......   *$### ##   *#.*#####   # #  # #
#    #.........###$  $.#    ####*.#@*.##* #      #
# $$ #..*...####*##$* $#.   #*.@.*#*$*   #### ####
# $$ .....###.*.@.##$* #@ #  .*#*.##*@*###**   **#
# $$ .*.###   *    .  .#  #  #.#.@.##.   #       #
#    ...#*   #@# # @  @# ##  #*#*.*.####*#  *#*  #
##########################@  ####*. .#.. #..#### #
#.@.   . . . . . .*. . .*    #*.###. #  ##  #.*.*#
#* *  . . . . .@. . .*. .   +# @ .  .#..@@..#*.*.#
# #  # .###. . ###########*+#+   * +##@ ..  # +###
# #  #.##*##. .#...*.. . #+#+  #    +#*######.*.*#
# # ## . .*##. #@..@... .##+  #* #+  #*#*** #*.*@#
#.#.#  ###. #  #..#### . #+  #* #+   ###@.. ###+ #
#***#    # .#  #.@#*.#. ..  #* #+*   .@##@. #@. .#
#@#@#  # # ##  #..#..# . #. .###*   #..@##@ #. . #
#*#*#  # #..*..#.....#. .#@. #      #*..@## # ####
######## #@#.**#@.@.@# . #. .#      ##*..@#  .*.*#
#..*.#   # #*..#######. .# . .       ##*..@ # .*.#
#.*.*#   ###.**..           #+# ###   ##*.@ #### #
#..#######..*##+   #       #+     +#   ##*. #*.*.#
#*..**.**.**##+    +#     #+  # #  +#   ##* #.*.@#
#..*..*..*. #+      +#   #+   +#+  .+#   #### ####
##### ## .@ #   $$   +# #+     +   *.+#       #**#
#     #*.@  #  #**#   +#+      .    *.+#   ####@ #
#. .# #.@   #  ####   ##.   #+ @*  # *.. ###**## #
#@ @# #@    #  @##@  ##.*  #+  ##  #  *@  $ .@.# #
#   # @     #   @@  ##.** #+    ## ##### ##  # # #
######## ###### .. ##.**@#+  #  *#  $$ . *##     #
#$.$.$.#.$. # # @@##.**@#+ * ### #   ##@  *##  + #
#$.$.$.#.. .#. ...#.**@#+ **  #+ +#   #    *## + #
#$$$.$.$.$. . . ..# *@#+     #+   +# ##  #  *#   #
#$.$.$.#.$ .#. ...#. ###$#####    *+##  ###  #* *#
#$.$.$.#.$. # .*@*# .             @     @    #@.@#
##################################################
