##################################################
#...........@ #*$#@@@@@@@#                       #
# .@..*....#*+# .@@@@@@$#  +#################### #
#*..@.. *..# .@ #*@@@@$#  +$*$*$*$*$*$*$*$*$*$*#@#
#.@...@..  @ #*$##@@@$#  +$*+#################$#@#
#... .....#*+# .@ @@$#  +$*+               $+$*+@#
#.*..*. *.# .@ #*#@$#@ +$*+         ###    #$*+@@#
#.....@...@ #*$# #@# . #*+      ##+  #     +*+@@@#
#@.*. ...#*+# .@  @  $ #$#  +#+ # #  #    +*$#@@+#
#..@...* # .@ #*# ###@ #*#  # # ##+  #   +*$@+.* #
#...*.@..@ #*$#   @@#..#$#  ### #    #  +*$@+  + #
#@. . ..#*+# .@  *...*#@@#  # # #      +*$@+  +# #
#.......# .@ #*# #####@@+   # #       +*$@+  +@# #
#. *@.@.@ #*$#   @@#*@@*# #          +*$@+  +@@# #
#*... .#*+# .@  *.. #@@*# #         +*$@+  +@@@# #
#.@.@..# .@ #*# ### #***  #$#      +*$@+  +@@@@# #
#..*...@ #*$#   @*# ##### #*######+*$@+  +@@@@@# #
#. .@*#*+# .@  *+#$     # #$*$*$*$*$@+  +@@@@@@# #
#*@.@ # .@ #*# #@*#  *  # ##########+  +@@@@@@@# #
#.@...@ #*$#   @@*# **  *             +@@@@@@@@# #
#.@..#*+# .@  *..##  *  ###$#####$####@@@@@@@@@# #
#.. .# .@ #*# ###@.  *  #@@#     #**@#$@@@@@@@@# #
#@.*.@ #*$#   @@#$  *** #**#   * #@@@@+$@@@@@@+# #
#* .#*+# .@  *.. $#     #**#  ** $+@@+  $@@@@+@# #
#...# .@ #*# ### ####### K*# * * # @+    $@@+$@# #
# ..@ #*$#   @*#   @@    **# *** # $    #@@+@ @# #
#@.#*+# .@  *+#$###@@####$##   * #@ #####@$#$ $  #
#. # .@ #*# ##     ..            .@@    #@###  @ #
#*.@ #*$#   @# ##########$########@@# #  @    #*##
#.#*+# .@  *+$ #                  ..  ###@## *#  #
# # .@ #*# #@# # **  ####$########@@###  @  ##@# #
#.@ #*$#   @+  #   * #**#         ..    #$   #*  #
##*+# .@  *+@@#$  *  #   @ ##### #@@# #$  $    # #
## .@ #*# #@.@.# *   #..@.+@*@*#  ..  #$      ## #
#@ #*$#   @+.@.@ *** # @.+@*@+.*#######$       # #
#*+# .@  *+@.#$.     #@.+@***@+.* .@*@#$       # #
# .@ #*# #@+.   ######+  +@*@+.*@.@.@. $       # #
# #*$#   @@*+@ $* @@ *    +@+*+.*@.@# #$       # #
#+# .@  *...#$   #@@#   # @*@ . @.@.@.#$       # #
#.@ #*# ####$  @@@.. ### .+### @##### #$       # #
##*$#   @@#*  @+#@##     +     #@     #$       # #
## .@  *..  .@+@#* $###### *** @#  ** #$       # #
#@ #*# ###  ..@@*#       # *   #@ *   #$       # #
#*$#   @@#$###@+ ### **  # **  @# *** #$       # #
# .@  *..@#   @  #     * #   * #@ * * #$       # #
# #*# ###@# #@+# #@#  *  # **  @#  *  #$      +#@#
#$#   @@#@* #. *#@@#   * #     #$     #+     +@@@#
#.@# *...@##$#   *@# **  #####$@@####$########@**#
# *  ###..       **#           *.             **@#
##################################################
