##################################################
#.@ *............................................#
# *.@....####### #######################$######@.#
#  @@....#***..# #** #        .......... #****#..#
#........#.@@..# #.@ # ##  *##*****....# #....#.*#
############# ## ### # #  *##@@@@@@...#+  *#+ #.@#
#*.                  # # *##.........#+  *#+  #..#
#.#   + . ###*## #  +# # ##@.@##@@..#+  *#+   #..#
#*# .  +*.   @ # ## .# # #@@.@@##@.#+  *#+    #*.#
#.# @.  +@     # #  @# #  ......##.+  *#+    ##..#
#*#  @.  +   ###.###*# #.#@@@@@....  *#+      $..#
#.#   @.   ###.....### #.#***#####  *#+   +#+ #..#
#*#    @. ##...#.#..   #.#####***# *#+    .+. #.@#
#.#.    @ ...###.#######.........###+  +  ... #.*#
#*.@       .##...... ....###..+..#****  +#@@@##..#
#### ###.. @*#.#####  ####*##@@..#.....  +#  *#.@#
#**  .... .###..#  #  #.*.@.#@*.##@@@@..  +# @#..#
# @# .....##*##.#  #  #.@...#*###.****...  +# #..#
#*.# ##..##.@...#  ####.....###...........  # #..#
#@    #..#*   @.#   #         ....@@@@.... *# #..#
##### #..##################################@# #..#
#***# #..  #   $ # #   #       #*##*      #@# #@.#
#*.*# ### .#.#.#. .#.#.#..#.....@.## #### ### #..#
#@  @ #K#    #...# # # ## #  #         *# #   #..#
####### # #.##@@@# .@. . .#*##..## ###### # # #..#
#...... . #  #   ###......# #   #  #*.      # $..#
#.##### +##  #####..###...###..##  ###.########.@#
#......**.   #........*+..#*# ....   . #     .#..#
#.......@.#..# ..#..@..*+.....##. . .###  + #@#..#
#......@... . ...##.....*+..###...   .   +* #@#..#
#..++#..*##### #####.....*+.#....##.# *+ *. #@#..#
#.++  .@++.. #.# ..++..@..*.#...##.@#  *++@ #@#..#
#++   *++.. .# #.@..++.....@##..#.@ #   *+  #@#..#
#..  *++.@.. #.#*....++..@.......@  #    *+  @#..#
#@#  ++...# .# #.*#.@.++.##..##########   . #*#..#
#@#  +@.@.#. # # .#...*+..#..#....#....   @ ###..#
#@#  ++...#*.# #. #..@++.@#.*#..#.#.##@###### #..#
#@#  *+*..#. . .@.#..++...#.@#..#.#.#.....#** #..#
#@$   *++@# .   .*#.++....#.*#..#.....###..@. #..#
#*# #  *++#### #####+..@.@#.@#..##....#**.### #..#
### ##  *++..    *#**@...## ##...####.#@@.#   #..#
#*#  #   *+*@ ########## . . #..@@@ @*#.**#   #..#
#*## ###  *++ .#. .#. .#. . .#..@.@.+@# @@# ###..#
# *# #*+#  *+  # # # # # ##.##.@@##@@.# ### @@#..#
#. * #* +#  . .#.#.#.#.#. # *#..@.##**#     **$..#
#@# .#   # # #   # # # ##.#.@#@.@.@***#@@    @#..#
#@##@  #.# #.#.#.#.#.#.#. # ###################..#
#$$#####@# #*#*#@# # # ##.#................*....*#
#$$$$$$$$  #.#.@.#. .#. . #....*.................#
##################################################
