##################################################
#*****+.@.@.@.. #    @  #@#@     **#    #*@    @*#
#####*+.......+.#*  ### #*..     **#### ##.    .##
#***#*+.####.++ #. @#   # # ########    #   ##+  #
#*#*#*+.#*@@..+.#  ## ### #      *##       ## #+ #
#*#*#*+.#*....+ #  *# #*# #       *# #######   # #
#*#*#*+.#####.+.#  ## # # # ####+    #*@@@$  +   #
#*#***+.......+ #   $ #        $#+   #*...$ +++  #
#*#####.#.#####.##### ######### $#+  ###### @ ++ #
#**** #.#.# . . . #           ## #  $$  #   .*+@ #
##### * #*#.#.#+ .#   ##   #+  #   $##@ #@ ++++. #
#*  # # ### # .#+ .    ##+  #+ # #####. #* +* ++ #
# # # # #  .## .#+ ##    #+  #@#....#*     + *   #
# # # # # + .## .#**# ##  #+  .#.**.### ##########
# # # #K# ++ .##*#### #....#+** ....#.$.         #
# #@# ### @+. .#.#.*  #.##.@### ###...$. ######@ #
# #*      .+ + #*.*#  #.@##.      #$..$.     @#. #
# ####### ++.+.#.*##  #.*.#  #*   ######   # .#  #
# # @ #  . @ + ####   #...#  ##*   #*@.#   # *# @#
#   * *    *+#  #    ####.#  @##*  ##. # ## ##  .#
#### ########## #### #       .*##* #*@.#         #
#*#....@..+ . . #*#  #    #  + *## ##. # ######@ #
#.####..#.+. . .# # ##  ###+  + *# #*@.# $*****. #
#.#.....#.. . . # #  ##   *#+  +   ##. # ######  #
#.#.######.#### # ##  # #+ *#+ #       #   #  # @#
#.#.#**@@#.#    # ###    #+ *# #   #$.##   #  # .#
#...#**.@#.# #### #@## +  #+ #   ###..#   @@##   #
#.###**@.#.#  # @ #*@..*+    # ###@@..#$# **     #
#.. #**..$..+ # . #.*...@+   #  #@...@# #    +   #
### ########@ # * #......*  *## #****.# # +++++  #
#   #       . # # #+...+    ##* ####### #  . + . #
# #### ###### * # #.+.+#   *   *        # . . .  #
# #.@.   @  ##### #...@# ### ############$#####+ #
# #*.* #..@ * #*# ....*#  #    . ......#.*. *#*#.#
# #@ . #* . #  .###.##### ##### ######.#*.*#@.@#.#
#  .###########...#*.*.*# #*  #.#....#.#.*.#...#.#
# # #*#. .#***###.#.*.*.# ### # #.##*#.#*.*....$.#
#@# # . # . . #...#####.# #   #.#.#**#.#########.#
#.  # #######.#.###*@@*.#*# ### #.####.#       #.#
# # # #.....# #...#.....###   #.#......#@..#*.*#.#
# # + #.###.#.###.#...... ### # ########.@.#.*.#.#
# # + #.#*#.# #...##..###      . . . . ...@#*.*..#
# # + #.#...#.#.###*....# +++  +++.@+++ ##########
#   + #.##### #...#####.#   @+ @  +. . .         #
#   + #.......#.#.#* *#.# + *+ + *+*.+.######### #
#*### #########.#.# # #   +++* +++..@+ # #...@.# #
#  *+ #*.*#*....#.# # # # +*@+ +  +*.+.# #...*.# #
## ## #.#.#.#####.# # # # +@*+ +  +.@. #  .@@..# #
#W *  .*#*.*#*   .$ #* *#  ..       .#.  #.***.#*#
##################################################
