++++++++++++++++++++++++++++++++++++++++++++++++++
+ *@*.......#**.@...#**#K #..*.#............... .+
+*@**++++.#.#** @.#.#**#  #..@.#.######..***...#@+
+@**@+**..#.#**  #..#*@# ##....#.#.......@@@.+.#@+
+****+**+.#**#* ## ##... #..*..#.#******....***#@+
++++++**+.#***# *.....## #..@.*#.#@@@@@@..+.@@@#@+
+****+@@+.#**#..@#.##@#$ #@...@#.######..***...#@+
+**@*++++.#@*#.@ #.....@ #...#.#.#$.**#..@@@.+. @+
+@*@*.....#@#.@..#*$###@##.*...#.#$.@@#.....***#*+
+#####.++.#..@   #*@ # # #.@...#.#@.###.....@@@##+
+****#.+...###########*  #.....#.#...............+
+****#.+.+..# ..... $****#...*.#.#...............+
+****#.+.@#...##.#. ##***$...@.#.#.@+@+...**.....+
+****#.+...##@##.## $ #*+@ #####..#+.+....@@###..+
+****#.+++.......#. @.**+@+**...#..+......###....+
+****#.+*++++++#.#.#@.#**@@+*.#..#.#    ..#$*@#..+
+****#.+*** * +..#*.#.#**@@@+..#...#    ..#$*@#..+
+*$**#.+***  $+..#*.#..##@@@@+..###     ..#$*@...+
+@@@*..+**#* @+.##*..#..#@@@@@#.#       ..#####..+
+######### ++@+**#@.#.#..#$$$##.#       .........+
+*       $  @ ***#.#...#..###...#...###..........+
+* #.....#########...#..#.....##...##........@@@.+
+* #      #. .**#$#####..#####...###......##.***.+
+* #......#.  @#$   #*#..#$***.###....#####...@+.+
+* #      #***# @ # # #..#$@@@.......##***###.++.+
+* #......##@  ###  + #..#####..#..........*..+*.+
+* #       #@.        #.........####.##.@@@##.++.+
+* #...... ###     +* #  #####..#.....######...+.+
+* #         ######@  #  #......#####...#........+
+* #......            #  #@.....#....... #.......+
+* #           .............#...++..........@***@+
+* #****** ****............@#..++..@........@***@+
+* #@@@@@@ @@@@..........####.++.@...*......@***@+
+* #****** ****..............++......@......@@@@@+
+* #@@@@@@ @@@@..............+....+...@@.........+
+* #****** ****.....   #........@..@.....@***@...+
+* #@@@@@@ @@@@.....   # #..++...........@***@...+
+* #****** ****.....  #####..++..@....@..@***@...+
+@.#@@@@@@ @@@@.....  $**** ...@...@.....@@@@@...+
+. #...... .........  #@#@#  ........@...........+
+ ### ##################################++++++++++
+..#**#**    .#*  #      #      #   ***#*********+
+*.#.##..#  #.#@# #  +#    #  #    # @@*.**@***.*+
+..#.....#  #.### ##  +#*#### ### #### ***@*.***@+
+..#..#.##  #.      ...#****# +*# #+*##*******@**+
+.*#.@#..# $#.+####*...#*####  $#K#**.#**@.****@*+
+..#*.#**#.@#.....#@*.@#*#***  @#@#@*@#@*****@**.+
+**#.*#**#$ #.###.#.@*.#*#####  ###.**#*@***@****+
+@@#.@#@@#@ #..*#*#..@*#******#   ...@#**********+
++++++++++++++++++++++++++++++++++++++++++++++++++
