##################################################
#  *  .*#*.*#*   .$ #* *#  ..       .#.  #.***.#*#
## ## #.#.#.#####.# # # # +@*+ +  +.@. #  .@@..# #
#  *+ #*.*#*....#.# # # # +*@+ +  +*.+.# #...*.# #
#*### #########.#.# # #   +++* +++..@+ # #...@.# #
#   + #.......#.#.#* *#.# + *+ + *+*.+.######### #
#   + #.##### #...#####.#   @+ @  +. . .         #
# # + #.#...#.#.###*....# +++  +++.@+++ ##########
# # + #.#*#.# #...##..###      . . . . ...@#*.*..#
# # + #.###.#.###.#...... ### # ########.@.#.*.#.#
# # # #.....# #...#.....###   #.#......#@..#*.*#.#
#.  # #######.#.###*@@*.#*# ### #.####.#       #.#
#@# # . # . . #...#####.# #   #.#.#**#.#########.#
# # #*#. .#***###.#.*.*.# ### # #.##*#.#*.*....$.#
#  .###########...#*.*.*# #*  #.#....#.#.*.#...#.#
# #@ . #* . #  .###.##### ##### ######.#*.*#@.@#.#
# #*.* #..@ * #*# ....*#  #    . ......#.*. *#*#.#
# #.@.   @  ##### #...@# ### ############$#####+ #
# #### ###### * # #.+.+#   *   *        # . . .  #
#   #       . # # #+...+    ##* ####### #  . + . #
### ########@ # * #......*  *## #****.# # +++++  #
#.. #**..$..+ # . #.*...@+   #  #@...@# #    +   #
#.###**@.#.#  # @ #*@..*+    # ###@@..#$# **     #
#...#**.@#.# #### #@## +  #+ #   ###..#   @@##   #
#.#.#**@@#.#    # ###    #+ *# #   #$.##   #  # .#
#.#.######.#### # ##  # #+ *#+ #       #   #  # @#
#.#.....#.. . . # #  ##   *#+  +   ##. # ######  #
#.####..#.+. . .# # ##  ###+  + *# #*@.# $*****. #
#*#....@..+ . . #*#  #    #  + *## ##. # ######@ #
#### ########## #### #       .*##* #*@.#         #
#   * *    *+#  #    ####.#  @##*  ##. # ## ##  .#
# # @ #  . @ + ####   #...#  ##*   #*@.#   # *# @#
# ####### ++.+.#.*##  #.*.#  #*   ######   # .#  #
# #*      .+ + #*.*#  #.@##.      #$..$.     @#. #
# #@# ### @+. .#.#.*  #.##.@### ###...$. ######@ #
# # # #K# ++ .##*#### #....#+** ....#.$.         #
# # # # # + .## .#**# ##  #+  .#.**.### ##########
# # # # #  .## .#+ ##    #+  #@#....#*     + *   #
#*  # # ### # .#+ .    ##+  #+ # #####. #* +* ++ #
##### * #*#.#.#+ .#   ##   #+  #   $##@ #@ ++++. #
#**** #.#.# . . . #           ## #  $$  #   .*+@ #
#*#####.#.#####.##### ######### $#+  ###### @ ++ #
#*#***+.......+ #   $ #        $#+   #*...$ +++  #
#*#*#*+.#####.+.#  ## # # # ####+    #*@@@$  +   #
#*#*#*+.#*....+ #  *# #*# #       *# #######   # #
#*#*#*+.#*@@..+.#  ## ### #      *##       ## #+ #
#***#*+.####.++ #. @#   # # ########    #   ##+  #
#####*+.......+.#*  ### #*..     **#### ##.    .##
#*****+.@.@.@.. #    @  #@#@     **#    #*@    @*#
##################################################
