##################################################
#         .....                                  #
#***#####....  ********************************* #
#####     ... @*                               * #
#          .. .*                               * #
# #   @@  + . .* ***  *    ****  **   *** **** * #
# # @@@@@@+ . .* * ** *    *    *  * *    *    * #
# # ******  . .* *  * *    *    *  * *    *    * #
# #   **   .. .* * ** *    *    *  * *    *    * #
#   +  ####.. .* ***  *    ***  ****  **  ***  * #
#  #####.##.. .* *    *    *    *  *    * *    * #
# ##  ##..#.. .* *    *    *    *  *    * *    * #
#  # ## .##.. .* *    *    *    *  *    * *    * #
#  #    ###.. .* *    **** **** *  * ***  **** * #
#  #      #.. .*                               * #
# ## *  @#*    *                               * #
# ### * .#     *  **** *** *  * ***  *** *  *  * #
# ##  #  #  @@@*  *     *  *  *  *  *    *  *  * #
#  # # #K# ++++*  *     *  *  *  *  *    *  *  * #
#  #    ##K    *  *     *  ** *  *  *    *  *  * #
# *#......#    *  ***   *  * **  *   **  ****  * #
# #.+++++.#    *  *     *  *  *  *     * *  *  * #
# #+*****.#..  *  *     *  *  *  *     * *  *  * #
# #.+++++.#.*. *  *     *  *  *  *     * *  *  * #
# #.......#.  .*  *    *** *  * *** ***  *  *  * #
# # @@+...... .*                               * #
# #  @@...#.. .*         *** *  * ****         * #
#     @   ##. .*          *  *  * *            * #
#         #.. .*          *  *  * *            * #
# #  *    #.  .*          *  *  * *            * #
# #.#######. . *          *  **** ***          * #
# #.#.....#. . *          *  *  * *            * #
# #.#.#.###.   *          *  *  * *            * #
# #.#.#.*##....*          *  *  * *            * #
# #.#.#####....*          *  *  * ****         * #
# #.#.....#.@@@*                               * #
# #.###.###....*    *    **** * * **** *    $  * #
# #......*#....*    *    *    * * *    *    $  * #
# #.#######....*    *    *    * * *    *    $  * #
#         #....*    *    *    * * *    *    $  * #
# @.      # ###*    *    ***  * * ***  *    $  * #
# +. * ++ @@..#*    *    *    * * *    *    $  * #
# #.    + # ..#*    *    *    * * *    *    $  * #
# #.      # ..#*    *    *     *  *    *       * #
# #. *  * # ..#*    **** ****  *  **** **** K  * #
# #.      # *.#*                               * #
# #.......# ..#********************************* #
# #@#######  .                                   #
#W        #* .#                                  #
##################################################
