##################################################
#...........@ #*$#@@@@@@@#                       #
# .@..*....#*+# .@@@@@@$#  +####################@#
#*..@.. *..# .@ #*@@@@$#  +$*$*$*$*$*$*$*     *#@#
#.@...@..  @ #*$##@@@$#  +$*+############ $$$ $#@#
#... .....#*+# .@ @@$#  +$*+            # $   *#@#
#.*..*. *.# .@ #*#@$#@ +$*+         ### # $$  $#@#
#.....@...@ #*$# #@# . #*+      ##+  #  #   $ *+@#
#@.*. ...#*+# .@  @  $ #$#  +#+ # #  #  # $$  +@@#
#..@...* # .@ #*# ###@ #*#  # # ##+  #  #    +@@*#
#...*.@..@ #*$#   @@#..#$#  ### #    #  #*##+ .* #
#@. . ..#*+# .@  *...$#@@#  # # #      +*$@+  ++ #
#.......# .@ #*# #####@@+   # #       +*$@+  +@# #
#. *@.@.@ #*$#   @@#*@@*# #          +*$@+  +@@# #
#*... .#*+# .@  *...#@@*# #         +*$@+  +@@@# #
#.@.@..# .@ #*# ### #***  #$#      +*$@+  +@@@@# #
#..*...@ #*$#   @*# ##### #*######+*$@+  +@@@@@# #
#. .@*#*+# .@  *+##     # #$*$*$*$*$@+  +@@@@@@# #
#*@.@ # .@ #*# #@*#  $  # ##########+  +@@@@@@@# #
#.@...@ #*$#   @@*# $$                +@@@@@@@@# #
#.@..#*+# .@  *..##  $  ##############@@@@@@@@@# #
#.. .# .@ #*# ###@.  $  #@@#     #**@#$@@@@@@@@# #
#@.*.@ #*$#   @@#$  $$$ #$$#   $ #@@@@+$@@@@@@+# #
#* .#*+# .@  *.. $#     #**#  $$ #+@@+  $@@@@+@# #
#...# .@ #*# ### ########K*# $ $ # @+    $@@+$@# #
# ..@ #*$#   @*#   @@    **# $$$ # $    #@@+@ @# #
#@.#*+# .@  *+#####@@####$##   $ #@ #####@$#$ $  #
#. # .@ #*# ##     ..            .@@    #@###  @ #
#*.@ #*$#   @# ##########$########@@# #  @    #*##
#.#*+# .@  *+# #                  ..  ###@## *#  #
# # .@ #*# #@# # $$  ####$########@@###  @  ##@# #
#.@ #*$#   @+  #   $ #**#         ..    #$   #*  #
##*+# .@  *+@@##  $  #   @ ##### #@@# #$  $    # #
## .@ #*# #@.@.# $   #..@.+@*@*#  ..  #$      ## #
#@ #*$#   @+.@.@ $$$ # @.+@*@+.*#######$       # #
#*+# .@  *+@.#$.     #@.+@***@+.* .@*@#$       # #
# .@ #*# #@+.   ######+  +@*@+.*@.@.@. $       # #
# #*$#   @@*+@ $  @@*#    +@+*+.*@.@# #$       # #
#+# .@  *...#$   #@@##  # @*@ . @.@.@.#$       # #
#.@ #*# ####$  @@@.. ### .+### @.@.@# #$       # #
##*$#   @@#*  @+#@##     +     #@.@.@.#$       # #
## .@  *..  .@+@#* #######  $$ @.@.@# #$       # #
#@ #*# ###  ..@@*#       # $   #@.@.@.#$       # #
#*$#   @@#$###@+ ### $$  # $$  @.@.@# #$       # #
# .@  *..@#   @  #     $ # $ $ #@.@.@.#$       # #
# #*# ###@# #@+# #@#  $  #  $  @#@#@# #$      +#@#
#$#   @@#@* #. *#@@#   $ #     #$. . .#+     +@@@#
#.@# *...@####   *@# $$  #####$@@####$########@**#
#W*  ###..       **#           *.             **@#
##################################################
