##################################################
#                                                #
#                                                #
#                                                #
#                                                #
#                                                #
#                                                #
#                                                #
#                                                #
#                                                #
#                                                #
#                                                #
#                                                #
#                                                #
#                                                #
#                                                #
#                                                #
#                                                #
#                                                #
#                                                #
#                                                #
#                                                #
#                                                #
#                                                #
#                                                #
#                                                #
#                                                #
#                                                #
#                                                #
#                                                #
#                                                #
#                                                #
#                                                #
#                                                #
#                                                #
#                                                #
#                                                #
#                                                #
#                                                #
#                                                #
#                                                #
#                                                #
#                                                #
#                                                #
#                                                #
#                                                #
#                                                #
#                                                #
#W*                                              #
##################################################
