##################################################
#$$$$$$$$  #.#.@.#. .#. . #....*.................#
#$$#####@# #*#*#@# # # ##.#................*....*#
#@##@  #.# #.#.#.#.#.#.#. # ###################..#
#@# .#   # # #   # # # ##.#.@#@.@.@***#@@    @#..#
#. * #* +#  . .#.#.#.#.#. # *#..@.##**#     **$..#
# *# #*+#  *+  # # # # # ##.##.@@##@@.# ### @@#..#
#*## ###  *++ .#. .#. .#. . .#..@.@.+@# @@# ###..#
#*#  #   *+*@ ########## . . #..@@@ @*#.**#   #..#
### ##  *++..    *#**@...## ##...####.#@@.#   #..#
#*# #  *++#### #####+..@.@#.@#..##....#**.### #..#
#@$   *++@# .   .*#.++....#.*#..#.....###..@. #..#
#@#  *+*..#. . .@.#..++...#.@#..#.#.#.....#** #..#
#@#  ++...#*.# #. #..@++.@#.*#..#.#.##@###### #..#
#@#  +@.@.#. # # .#...*+..#..#....#....   @ ###..#
#@#  ++...# .# #.*#.@.++.##..##########   . #*#..#
#..  *++.@.. #.#*....++..@.......@  #    *+  @#..#
#++   *++.. .# #.@..++.....@##..#.@ #   *+  #@#..#
#.++  .@++.. #.# ..++..@..*.#...##.@#  *++@ #@#..#
#..++#..*##### #####.....*+.#....##.# *+ *. #@#..#
#......@... . ...##.....*+..###...   .   +* #@#..#
#.......@.#..# ..#..@..*+.....##. . .###  + #@#..#
#......**.   #........*+..#*# ....   . #     .#..#
#.##### +##  #####..###...###..##  ###.########.@#
#...... . #  #   ###......# #   #  #*.      # $..#
####### # #.##@@@# .@. . .#*##..## ###### # # #..#
#@  @ #K#    #...# # # ## #  #         *# #   #..#
#*.*# ### .#.#.#. .#.#.#..#.....@.## #### ### #..#
#***# #..  #   $ # #   #       #*##*      #@# #@.#
##### #..##################################@# #..#
#@    #..#*   @.#   #         ....@@@@.... *# #..#
#*.# ##..##.@...#  ####.....###...........  # #..#
# @# .....##*##.#  #  #.@...#*###.****...  +# #..#
#**  .... .###..#  #  #.*.@.#@*.##@@@@..  +# @#..#
#### ###.. @*#.#####  ####*##@@..#.....  +#  *#.@#
#*.@       .##...... ....###..+..#****  +#@@@##..#
#.#.    @ ...###.#######.........###+  +  ... #.*#
#*#    @. ##...#.#..   #.#####***# *#+    .+. #.@#
#.#   @.   ###.....### #.#***#####  *#+   +#+ #..#
#*#  @.  +   ###.###*# #.#@@@@@....  *#+      $..#
#.# @.  +@     # #  @# #  ......##.+  *#+    ##..#
#*# .  +*.   @ # ## .# # #@@.@@##@.#+  *#+    #*.#
#.#   + . ###*## #  +# # ##@.@##@@..#+  *#+   #..#
#*.                  # # *##.........#+  *#+  #..#
############# ## ### # #  *##@@@@@@...#+  *#+ #.@#
#........#.@@..# #.@ # ##  *##*****....# #....#.*#
#  @@....#***..# #** #        .......... #****#..#
# *.@....####### #######################$######@.#
#W@ *............................................#
##################################################
