##################################################
#         .....                                  #
#***#####....                                    #
#####     ... @                                  #
#          .. .                                  #
# #   @@  + . .                                  #
# # @@@@@@+ . .                                  #
# # ******  . .                                  #
# #   **   .. .                                  #
#   +  ####.. .                                  #
#  #####.##.. .                                  #
# ##  ##..#.. .                                  #
#  # ## .##.. .                                  #
#  #    ###.. .                                  #
#  #      #.. .                                  #
# ## *  @#*                                      #
# ### * .#                                       #
# ##  #  #  @@@                                  #
#  # # #K# ++++                                  #
#  #    ##K                                      #
# *#......#                                      #
# #.+++++.#                                      #
# #+*****.#..                                    #
# #.+++++.#.*.                                   #
# #.......#.  .                                  #
# # @@+...... .                                  #
# #  @@...#.. .                                  #
#     @   ##. .                                  #
#         #.. .                                  #
# #  *    #.  .                                  #
# #.#######. .                                   #
# #.#.....#. .                                   #
# #.#.#.###.                                     #
# #.#.#.*##....                                  #
# #.#.#####....                                  #
# #.#.....#.@@@                                  #
# #.###.###....                                  #
# #......*#....                                  #
# #.#######....                                  #
#         #....                                  #
# @.      # ###                                  #
# +. * ++ @@..#                                  #
# #.    + # ..#                                  #
# #.      # ..#                                  #
# #. *  * # ..#                                  #
# #.      # *.#                                  #
# #.......# ..#                                  #
# #@#######  .                                   #
#W        #* .#                                  #
##################################################
