++++++++++++++++++++++++++++++++++++++++++++++++++
+@@#.@#@@#@ #..*#*#..@*#******#   ...@#**********+
+**#.*#**#$ #.###.#.@*.#*#####  ###.**#*@***@****+
+..#*.#**#.@#.....#@*.@#*#***  @#@#@*@#@*****@**.+
+.*#.@#..# $#.+####*...#*####  $#K#**.#**@.****@*+
+..#..#.##  #.      ...#****# +*# #+*##*******@**+
+..#.....#  #.### ##  +#*#### ### #### ***@*.***@+
+*.#.##..#  #.#@# #  +#    #  #    # @@*.**@***.*+
+..#**#**    .#*  #      #      #   ***#*********+
+ ### ##################################++++++++++
+. #...... .........  #@#@#  ........@...........+
+@.#@@@@@@ @@@@.....  $**** ...@...@.....@@@@@...+
+* #****** ****.....  #####..++..@....@..@***@...+
+* #@@@@@@ @@@@.....   # #..++...........@***@...+
+* #****** ****.....   #........@..@.....@***@...+
+* #@@@@@@ @@@@..............+....+...@@.........+
+* #****** ****..............++......@......@@@@@+
+* #@@@@@@ @@@@..........####.++.@...*......@***@+
+* #****** ****............@#..++..@........@***@+
+* #           .............#...++..........@***@+
+* #......            #  #@.....#....... #.......+
+* #         ######@  #  #......#####...#........+
+* #...... ###     +* #  #####..#.....######...+.+
+* #       #@.        #.........####.##.@@@##.++.+
+* #......##@  ###  + #..#####..#..........*..+*.+
+* #      #***# @ # # #..#$@@@.......##***###.++.+
+* #......#.  @#$   #*#..#$***.###....#####...@+.+
+* #      #. .**#$#####..#####...###......##.***.+
+* #.....#########...#..#.....##...##........@@@.+
+*       $  @ ***#.#...#..###...#...###..........+
+######### ++@+**#@.#.#..#$$$##.#       .........+
+@@@*..+**#* @+.##*..#..#@@@@@#.#       ..#####..+
+*$**#.+***  $+..#*.#..##@@@@+..###     ..#$*@...+
+****#.+*** * +..#*.#.#**@@@+..#...#    ..#$*@#..+
+****#.+*++++++#.#.#@.#**@@+*.#..#.#    ..#$*@#..+
+****#.+++.......#. @.**+@+**...#..+......###....+
+****#.+...##@##.## $ #*+@ #####..#+.+....@@###..+
+****#.+.@#...##.#. ##***$...@.#.#.@+@+...**.....+
+****#.+.+..# ..... $****#...*.#.#...............+
+****#.+...###########*  #.....#.#...............+
+#####.++.#..@   #*@ # # #.@...#.#@.###.....@@@##+
+@*@*.....#@#.@..#*$###@##.*...#.#$.@@#.....***#*+
+**@*++++.#@*#.@ #.....@ #...#.#.#$.**#..@@@.+. @+
+****+@@+.#**#..@#.##@#$ #@...@#.######..***...#@+
++++++**+.#***# *.....## #..@.*#.#@@@@@@..+.@@@#@+
+****+**+.#**#* ## ##... #..*..#.#******....***#@+
+@**@+**..#.#**  #..#*@# ##....#.#.......@@@.+.#@+
+*@**++++.#.#** @.#.#**#  #..@.#.######..***...#@+
+W*@*.......#**.@...#**#K #..*.#............... .+
++++++++++++++++++++++++++++++++++++++++++++++++++
