##################################################
#...........@ #*$#@@@@@@@#                       #
# .@..*....#*+# .@@@@@@$#  +####################@#
#*..@.. *..# .@ #*@@@@$#  +$*$*$*$*$*$*$*     *#@#
#.@...@..  @ #*$##@@@$#  +$*+############ $$$ $#@#
#... .....#*+# .@ @@$#  +$*+            # $   *#@#
#.*..*. *.# .@ #*#@$#@ +$*+         ### # $$  $#@#
#.....@...@ #*$# #@# . #*+      ##+  #  #   $ *+@#
#@.*. ...#*+# .@  @  $ #$#  +#+ # #  #  # $$  +@@#
#..@...* # .@ #*# ###@ #*#  # # ##+  #  #    +@@*#
#...*.@..@ #*$#   @@#..#$#  ### #    #  #*##+ .* #
#@. . ..#*+# .@  *...*#@@#  # # #      +*$@+  ++ #
#.......# .@ #*# #####@@+   # #       +*$@+  +@# #
#. *@.@.@ #*$#   @@#*@@*# #          +*$@+  +@@# #
#*... .#*+# .@  *.. #@@*# #         +*$@+  +@@@# #
#.@.@..# .@ #*# ### #***  #$#      +*$@+  +@@@@# #
#..*...@ #*$#   @*# ##### #*######+*$@+  +@@@@@# #
#. .@*#*+# .@  *+#$     # #$*$*$*$*$@+  +@@@@@@# #
#*@.@ # .@ #*# #@*#  $  # ##########+  +@@@@@@@# #
#.@...@ #*$#   @@*# $$                +@@@@@@@@# #
#.@..#*+# .@  *..##  $  ###$#####$####@@@@@@@@@# #
#.. .# .@ #*# ###@.  $  #@@#     #**@#$@@@@@@@@# #
#@.*.@ #*$#   @@#$  $$$ #$$#   $ #@@@@+$@@@@@@+# #
#* .#*+# .@  *.. $#     #**#  $$ $+@@+  $@@@@+@# #
#...# .@ #*# ### ########K*# $ $ # @+    $@@+$@# #
# ..@ #*$#   @*#   @@    **# $$$ # $    #@@+@ @# #
#@.#*+# .@  *+#$###@@####$##   $ #@ #####@$#$ $  #
#. # .@ #*# ##     ..            .@@    #@###  @ #
#*.@ #*$#   @# ##########$########@@# #  @    #*##
#.#*+# .@  *+$ #                  ..  ###@## *#  #
# # .@ #*# #@# # $$  ####$########@@###  @  ##@# #
#.@ #*$#   @+  #   $ #**#         ..    #$   #*  #
##*+# .@  *+@@#$  $  #   @ ##### #@@# #$  $    # #
## .@ #*# #@.@.# $   #..@.+@*@*#  ..  #$      #$ #
#@ #*$#   @+.@.@ $$$ # @.+@*@+.*#######$       # #
#*+# .@  *+@.#$.     #@.+@***@+.* .@*@#$       # #
# .@ #*# #@+.   ######+  +@*@+.*@.@.@. $       # #
# #*$#   @@*+@ $  @@*#    +@+*+.*@.@# #$       # #
#+# .@  *...#$   #@@##  # @*@ . @.@.@.#$       # #
#.@ #*# ####$  @@@.. ### .+### @.@.@# #$       # #
##*$#   @@#*  @+#@##     +     #@.@.@.#$       # #
## .@  *..  .@+@#* $######  $$ @.@.@# #$       # #
#@ #*# ###  ..@@*#       # $   #@.@.@.#$       # #
#*$#   @@#$###@+ ### $$  # $$  @.@.@# #$       # #
# .@  *..@#   @  #     $ # $ $ #@.@.@.#$       # #
# #*# ###@# #@+# #@#  $  #  $  @#@#@# #$      +#@#
#$#   @@#@* #. *#@@#   $ #     #$. . .#+     +@@@#
#.@# *...@##$#   *@# $$  #####$@@####$########@**#
#W*  ###..       **#           *.             **@#
##################################################
