##################################################
#$.$.$.#.$. # .*@*# .             @     @    #@.@#
#$.$.$.#.$ .#. ...#. ###$#####    *+##  ###  #* *#
#$$$.$.$.$. . . ..# *@#+     #+   +# ##  #  *#   #
#$.$.$.#.. .#. ...#.**@#+ **  #+ +#   #    *## + #
#$.$.$.#.$. # # @@##.**@#+ * ### #   ##@  *##  + #
######## ###### .. ##.**@#+  #  *#  $$ . *##     #
#   # @     #   @@  ##.** #+    ## ##### ##  # # #
#@ @# #@    #  @##@  ##.*  #+  ##  #  *@  $ .@.# #
#. .# #.@   #  ####   ##.   #+ @*  # *.. ###**## #
#     #*.@  #  #**#   +#+      .    *.+#   ####@ #
##### ## .@ #   $$   +# #+     +   *.+#       #**#
#..*..*..*. #+      +#   #+   +#+  .+#   #### ####
#*..**.**.**##+    +#     #+  # #  +#   ##* #.*.@#
#..#######..*##+   #       #+     +#   ##*. #*.*.#
#.*.*#   ###.**..           #+# ###   ##*.@ #### #
#..*.#   # #*..#######. .# . .       ##*..@ # .*.#
######## #@#.**#@.@.@# . #. .#      ##*..@#  .*.*#
#*#*#  # #..*..#.....#. .#@. #      #*..@## # ####
#@#@#  # # ##  #..#..# . #. .###*   #..@##@ #. . #
#***#    # .#  #.@#*.#. ..  #* #+*   .@##@. #@. .#
#.#.#  ###. #  #..#### . #+  #* #+   ###@.. ###+ #
# # ## . .*##. #@..@... .##+  #* #+  #*#*** #*.*@#
# #  #.##*##. .#...*.. . #+#+  #    +#*######.*.*#
# #  # .###. . ###########*+#+   * +##@ ..  # +###
#* *  . . . . .@. . .*. .   +# @ .  .#..@@..#*.*.#
#.@.   . . . . . .*. . .*    #*.###. #  ##  #.*.*#
##########################@  ####*. .#.. #..#### #
#    ...#*   #@# # @  @# ##  #*#*.*.####*#  *#*  #
# $$ .*.###   *    .  .#  #  #.#.@.##.   #       #
# $$ .....###.*.@.##$* #@ #  .*#*.##*@*###**   **#
# $$ #..*...####*##$* $#.   #*.@.*#*$*   #### ####
#    #.........###$  $.#    ####*.#@*.##* #      #
#########.......   *$### ##   *#.*#####   # #  # #
# **#** #####...  *$#@    #   *# .#@*$    #      #
# #*#*# #  ....#  $##.  *.  # *#. #*.+ @  #  ##  #
# ##### #  @...#  ###  *.#### *# .$..# .  # @  @ #
#         +#####    # *.##    ########## @# #**# #
# #####  +#    #*   #*.## *#   @     #* *.#. ##. #
#     #        #### #### *###  *# #  # *  ##. . .#
#    @#              ## *##@##### #########. . . #
#   @.#              #     .          @   @ . . .#
#   ..  +####    ##  #  ###..#.@.#.# @.+ #######$#
#   ### ##  #  @#  # #.#  @#.##*##.# .+# .@.    .#
#@.@#   #   #  .#  # #.# *.@.#.#.#.#.+.#.*.*# ####
#***# ##### #   #### #.# * ..#...#.#*#*#@.@.# #@*#
##.## #**.. #   #@K$ #.# .*#.#...#.##*.#.*.*# #*.#
#.*.# ##@#  #@# #.@# #..###..#...#.#*.*#@.@.# @.*#
#W..#   .    .    .  $.............*.*.** * $ $  #
##################################################
